8
10
WWWWWWWWWW
WWWWWWEEWW
WEBEEBEEWW
WEWEEFBEWW
WEEFEWFPEW
WWBWEFBEEW
WWEEEWWWWW
WWWWWWWWWW