7
7
WWWWWWW
WPEBEFW
WEBBBFW
WEEBEFW
WWEEEFW
GWWWEFW
GGGWWWW