10
15
GGGGGGWWWGGGGGG
GGGGGGWFWGGGGGG
GGWWWWWFWWWWWGG
GWWEEEEEEEEEWWG
WWEEWEWEWEWEEWW
WEEWWEEEEEWWEEW
WEWWEEWEWEEWWEW
WEEEEEBPBEEEEEW
WWWWEEWWWEEWWWW
GGGWWWWGWWWWGGG