11
15
GGGGGGGGGGGWWWW
GGGGGGWWWWWWEEW
WWWWWWWEEEEEEEW
WEEEEEEEEWWWWFW
WEBEEWWWBWEEWFW
WWEWWWPEEWEEWFW
WEEBEWWWBWEEWFW
WEEEBEEEEWWWWFW
WWWWWWWEEEEEEEW
GGGGGGWWWWWWEEW
GGGGGGGGGGGWWWW