12
11
WWWWWWWWGGG
WEEWEEEWGGG
WEEEBEEWGGG
WEBWWEWWWWW
WWEWFEWWEEW
GWEWFEEEBEW
GWEWFEWWEEW
GWEWFWWWEWW
GWPEEEWWEEW
GWWEBEEEEEW
GGWWWWWWEEW
GGGGGGGWWWW