9
9
GWWWWWWWW
WWEEWEEEW
WEEBFEEEW
WEEFBFBEW
WWFBEBFWW
WEBFBFPEW
WEEEFBEEW
WWEEWEEWW
GWWWWWWWG