14
15
GGGGGWWWWWGGGGG
GGGGWWEEEWGGGGG
GGGGWEEEEWGGGGG
GGWWWEEEEWWWWWW
GGWFWFWEWWFEEEW
WWWEWWWEEWWEEEW
WEEEWEEBEEWWEWW
WEEEEEBPBEEEEEW
WEEEWEEBEEWEEEW
WWWWWWEEEWWWEWW
GWEEFWWEWWWWEWG
GWEEEEEEEEEEEWG
GWWEEWWWWWWWWWG
GGWWWWGGGGGGGGG