13
15
GGGGGWWWWWGGGGG
GGGGWWEEEWWGGGG
GGWWWEBEBEWWWGG
GWWEEEWEWEEEWWG
WWEEEEEEEEEEEWW
WEBWEEFFFEWBEEW
WEEEEEFPFEEEEEW
WEEBWEFFFEEWBEW
WWEEEEEEEEEEEWW
GWWEEEWEWEEEWWG
GGWWWEBEBEWWWGG
GGGGWWEEEWWGGGG
GGGGGWWWWWGGGGG