14
12
WWWWWWWWWWGG
WFWEEWEEEWWW
WFWEBWBWEWEW
WFWEEEEWEBEW
WFWWBWEWEWEW
WEEEEEEEEWEW
WPEEEWWWEEEW
WEEEEEEEEWWW
WFWWBWBWEWGG
WFWEEWEWEWWG
WFWEBWEEBEWG
WFWEEEEWEEWG
WWWWWWWWEEWG
GGGGGGGWWWWG