13
13
GGGGGWWWWWGGG
GGGGGWEEEWGGG
GGGGGWEEEWGGG
WWWWGWEEEWGGG
WEEWWWWBWWWWW
WEEEEEEEEEEEW
WEFWWEWEWWFEW
WEEEEEEEEEEEW
WWWWWBWWWWEEW
GGGWEEEWGWWWW
GGGWEPEWGGGGG
GGGWEEEWGGGGG
GGGWWWWWGGGGG