11
18
WWWWWGGGGGGGGGGGGG
WEEEWWWWWGGGGGGGGG
WEBEEEEEWGGWWWWWGG
WEBWEPWEWWWWFEFWWW
WEBEBWWEWEEEEEFFFW
WWWBEEEEWEEWWEFFFW
GGWEEEEBEEEEWWEWWW
GGWWWWEEWWBBEEEWGG
GGGGGWWWWWEEWWWWGG
GGGGGGGGGWEEWGGGGG
GGGGGGGGGWWWWGGGGG