9
13
GWWWWWWWWWWWG
WWEEEEEEWEEWG
WEEWFEEEWEEWG
WEEEEEEFWEEWG
WWBBWWPWWBBWW
GWEEWFEEEEEEW
GWEEWEEEFWEEW
GWEEWEEEEEEWW
GWWWWWWWWWWWG