12
11
GGGGGWWWWWW
GGGWWWWEEEW
GGGWEEWEEEW
GWWWEEBEEEW
GWFFEBEBEEW
GWFFEWWWBWW
GWFFEEBEEEW
WWWEWWEEBEW
WEEEWWEWEPW
WEWWWEEWWWW
WEEEEEWWGGG
WWWWWWWGGGG