10
13
WWWWWWWGWWWWG
WEEEEEWWWEEWG
WEBBEBEEEEEWG
WEEBBEEWWWEWG
WEBBEEWEEWEWG
WEEEEWWEEWEWW
WWWWWFFEFWEEW
GGGGWFFEPEEEW
GGGGWFFEEWWWW
GGGGWWWWWWGGG